1111111111111
11C1111111111
11000000000E1
11P0N000000N1
11C1111111111
1111111111111