1111111111111
11C1111111111
11P00000001E1
1100100000001
11C1111111111
1111111111111