1111111111111
11C1111111111
11P00000000E1
1100000000001
11C1111111111
1111111111111